1111111
10PEC01
1000001
1000001
