111111111
10000000111
1PEC000111
100000001
111111111
