0111111111110
10E0000000001
10C0011111001
10P0000001001
0111111111110