1111111111111111111111111
1P01111111111100000000001
1000000000000000000000001
1000000000000000000000001
1000000001111100000000001
1000000000000000000000001
11111111111000000000C0001
1000111111111100000000001
1000000000011111000000001
1000000000000000000000001
1000000000001111111000001
1000000000000000000000001
1000000111100000000000001
1000000000000000000E00001
1111111111111111111111111
