11111111
1PEECC11
10000001
100000P1
11111111
