11111111111111111
1111E100111111111
11110000011111111
11100000011111111
11000000011111111
100000P0000000001
11000000000000011
11000000000000111
11C00000000001111
11111111111111111
11111111111111111
